b	closepath, fill,stroke	Close, fill, and stroke path using nonzero winding number rule
B	fill, stroke	Fill and stroke path using nonzero winding number rule
b*	closepath, eofill,stroke	Close, fill, and stroke path using even-odd rule
B*	eofill, stroke	Fill and stroke path using even-odd rule
BDC		(PDF 1.2) Begin marked-content sequence with property list
BI		Begin inline image object
BMC		(PDF 1.2) Begin marked-content sequence
BT		Begin text object
BX		(PDF 1.1) Begin compatibility section
c	curveto	Append curved segment to path (three control points)
cm	concat	Concatenate matrix to current transformation matrix
CS	setcolorspace	(PDF 1.1) Set color space for stroking operations
cs	setcolorspace	(PDF 1.1) Set color space for nonstroking operations
d	setdash	Set line dash pattern
d0	setcharwidth	Set glyph width in Type 3 font
d1	setcachedevice	Set glyph width and bounding box in Type 3 font
Do		Invoke named XObject
DP		(PDF 1.2) Define marked-content point with property list
EI		End inline image object
EMC		(PDF 1.2) End marked-content sequence
ET		End text object
EX		(PDF 1.1) End compatibility section
f	fill	Fill path using nonzero winding number rule
F	fill	Fill path using nonzero winding number rule (obsolete)
f*	eofill	Fill path using even-odd rule
G	setgray	Set gray level for stroking operations
g	setgray	Set gray level for nonstroking operations
gs		(PDF 1.2) Set parameters from graphics state parameter dictionary
h	closepath	Close subpath
i	setflat	Set flatness tolerance
ID		Begin inline image data
j	setlinejoin	Set line join style
J	setlinecap	Set line cap style
K	setcmykcolor	Set CMYK color for stroking operations
k	setcmykcolor	Set CMYK color for nonstroking operations
l	lineto	Append straight line segment to path
m	moveto	Begin new subpath
M	setmiterlimit	Set miter limit
MP		(PDF 1.2) Define marked-content point
n		End path without filling or stroking
q	gsave	Save graphics state
Q	grestore	Restore graphics state
re		Append rectangle to path
RG	setrgbcolor	Set RGB color for stroking operations
rg	setrgbcolor	Set RGB color for nonstroking operations
ri		Set color rendering intent
s	closepath, stroke	Close and stroke path
S	stroke	Stroke path
SC	setcolor	(PDF 1.1) Set color for stroking operations
sc	setcolor	(PDF 1.1) Set color for nonstroking operations4.21
SCN	setcolor	(PDF 1.2) Set color for stroking operations (ICCBased and special color spaces)
scn	setcolor	(PDF 1.2) Set color for nonstroking operations (ICCBased and special color spaces)
sh	shfill	(PDF 1.3) Paint area defined by shading pattern
T*		Move to start of next text line
Tc		Set character spacing
Td		Move text position
TD		Move text position and set leading
Tf	selectfont	Set text font and size
Tj	show	Show text
TJ		Show text, allowing individual glyph positioning
TL		Set text leading
Tm		Set text matrix and text line matrix
Tr		Set text rendering mode
Ts		Set text rise
Tw		Set word spacing
Tz		Set horizontal text scaling
v	curveto	Append curved segment to path (initial point replicated)
w	setlinewidth	Set line width
W	clip	Set clipping path using nonzero winding number rule
W*	eoclip	Set clipping path using even-odd rule
y	curveto	Append curved segment to path (final point replicated)
'		Move to next line and show text
"		Set word and character spacing, move to next line, and show text



















































